Starting amount =,5000, , Ending amount =,6.56
Transaction Number, Direction, Symbol, Amount of Shares, Amount in Dollars, Current Balance
17,BUY,F,1,-15.5900,6.56
16,BUY,AMC,1,-36.7000,22.15
15,BUY,F,3,-46.7700,58.85
14,BUY,AMC,2,-73.4000,105.62
13,BUY,F,7,-109.1300,179.02
12,BUY,AMD,2,-209.7200,288.15
11,BUY,AMC,9,-330.3000,497.87
10,BUY,F,35,-545.6500,828.17
9,BUY,AMD,8,-838.8800,1373.82
8,BUY,TSLA,1,-805.5000,2212.70
7,BUY,AMC,54,-1981.8000,3018.20
